WWWWWWWWWWWWWWWW
WXXXXXXXXXXXXXXW
WXXXXXXXXXXXXXXW
WXXXXXXXXXXDDDXW
WXEXXBXXXXXDODXW
WXXXXXXXXXXDDDXW
WXXXXXXXXXXXXXXW
WXXXXXXXXXXXXXXW
WXXXXXXXHXXXXXXW
WWWWWWWWWWWWWWWW