WWWWWWWWWWWWWWWW
WXXXXXXXXXXXXXXW
WXXXXXXXXXXXXXXW
WXXXXXXXXXXXXXXW
WXEXXXXXXXXXOXXW
WXXXXXXXXXXXXXXW
WXXXXXXXXXXXXXXW
WXXXXXXXXXXXXXXW
WXXXXXXXXXXXXXXW
WWWWWWWWWWWWWWWW