WWWWWWWWWWWWWWWW
WXXXXXXXXXXXXXXW
WXXXXXXXXXXXXXXW
WXXXXXXXXXXWWWXW
WXEXXBXXXFXWOWXW
WXXXXXXXXXXWWWXW
WXXXXXXXXXXXXXXW
WXXXXXXXXXXXXXXW
WXXXXXXXXXXXXXXW
WWWWWWWWWWWWWWWW